# Gboard Dictionary version:1
id	I’d	
idnt	I’d’nt	
idntve	I’d’nt’ve	
idve	I’d’ve	
ill	I’ll	
im	I’m	
ive	I’ve	
maam	Ma’am	
aint	ain’t	
amnt	amn’t	
arent	aren’t	
cant	can’t	
couldnt	couldn’t	
couldve	could’ve	
darent	daren’t	
daresnt	daresn’t	
dasnt	dasn’t	
didnt	didn’t	
doesnt	doesn’t	
dont	don’t	
everybodys	everybody’s	
everyones	everyone’s	
hadnt	hadn’t	
hadve	had’ve	
hasnt	hasn’t	
havent	haven’t	
hered	here’d	
herell	here’ll	
herere	here’re	
heres	here’s	
hed	he’d	
hell	he’ll	
hes	he’s	
howd	how’d	
howll	how’ll	
howre	how’re	
hows	how’s	
howve	how’ve	
isnt	isn’t	
itd	it’d	
itll	it’ll	
its	it’s	
lets	let’s	
maynt	mayn’t	
mayve	may’ve	
mightnt	mightn’t	
mightve	might’ve	
mustnt	mustn’t	
mustntve	mustn’t’ve	
mustve	must’ve	
neednt	needn’t	
oughtnt	oughtn’t	
oclock	o’clock	
shallnt	shalln’t	
shant	shan’t	
shed	she’d	
shell	she’ll	
shes	she’s	
shouldnt	shouldn’t	
shouldve	should’ve	
somebodyd	somebody’d	
somebodyll	somebody’ll	
somebodys	somebody’s	
someoned	someone’d	
someonell	someone’ll	
someones	someone’s	
somethingd	something’d	
somethingll	something’ll	
somethings	something’s	
thatd	that’d	
thatll	that’ll	
thats	that’s	
thered	there’d	
therell	there’ll	
therere	there’re	
theres	there’s	
thesed	these’d	
thesell	these’ll	
thesere	these’re	
theseve	these’ve	
theyd	they’d	
theyll	they’ll	
theyre	they’re	
theyve	they’ve	
thisd	this’d	
thisll	this’ll	
thiss	this’s	
thosed	those’d	
thosell	those’ll	
thosere	those’re	
wasnt	wasn’t	
werent	weren’t	
wed	we’d	
wedve	we’d’ve	
well	we’ll	
we’d	we’re	
weve	we’ve	
whatd	what’d	
whatll	what’ll	
whatre	what’re	
whats	what’s	
whatve	what’ve	
whend	when’d	
whenll	when’ll	
whenre	when’re	
whens	when’s	
whenve	when’ve	
whered	where’d	
wherell	where’ll	
wherere	where’re	
wheres	where’s	
whereve	where’ve	
whichd	which’d	
whichll	which’ll	
whichre	which’re	
whichs	which’s	
whichve	which’ve	
whod	who’d	
whodve	who’d’ve	
wholl	who’ll	
whore	who’re	
whos	who’s	
whove	who’ve	
whyd	why’d	
whyll	why’ll	
whyre	why’re	
whys	why’s	
whyve	why’ve	
willnt	willn’t	
willve	will’ve	
wont	won’t	
wouldnt	wouldn’t	
wouldntve	wouldn’t’ve	
wouldve	would’ve	
youd	you’d	
youll	you’ll	
youre	you’re	
youve	you’ve	
yall	y’all	
bout	’bout	
